OOOOOOOOOOOOOOOOOOOOO
OPPPPPPPPPPPPPPPPPPPO
OPOPOPOPOPOPOPOPOPOPO
OPPSPSPPPPPPPPPSPSPPO
OPOPOPOPOPOPOPOPOPOPO
OPPSPPPPPPPPPPPPPSPPO
OPOPOPOPOPOPOPOPOPOPO
OPPPPPPPPPPPPPPPPPPPO
OPOPOPOPOPOPOPOPOPOPO
OPPPPPPPPPPPPPPPPPPPO
OPOPOPOPOPOPOPOPOPOPO
OPPPPPPPPPCPPPPPPPPPO
OPOPOPOPOPOPOPOPOPOPO
OPPPPPPPPPPPPPPPPPPPO
OPOPOPOPOPOPOPOPOPOPO
OPPPPPPPPPPPPPPPPPPPO
OPOPOPOPOPOPOPOPOPOPO
OPPSPPPPPPPPPPPPPSPPO
OPOPOPOPOPOPOPOPOPOPO
OPPSPSPPPPPPPPSPPSPPO
OPOPOPOPOPOPOPOPOPOPO
OPPPPPPPPPPPPPPPPPPPO
OOOOOOOOOOOOOOOOOOOOO