OOOOOOOOOOOOOOOOO
OPPPPPPPOPPPPPPPO
OPPPSPPPOPPPSPPPO
OPPPPPPPOPPPPPPPO
OPPPOPPPPPPPOPSPO
OPPPCPPPOPPPPPPPO
OPPPPPPPOPSPPPPPO
OPPPPPPPOPPPPPPPO
OOOOOOOOOOOOPOOOO
OOOOOOOOOPPPPPPPO
OOOOOOOOOPPPPPPPO
OOOOOOOOOPPPPPPPO
OOOOOOOOOPSPOPSPO
OOOOOOOOOPPPPPPPO
OOOOOOOOOPPPPPPPO
OOOOOOOOOPPPPPPPO
OOOOOOOOOOOOOOOOO