OOOOOOOOOOOOOOOOO
OPPPPPPPSPPPPPPPO
OPPPPPPPSPPPPPPPO
OPPOOOOOOOOOOOPPO
OPPOOOOOOOOOOOPPO
OPPOOOOOOOOOOOPPO
OPPOOOOOPOOOOOPPO
OPPOOOOPPPOOOOPPO
OSSPPPPPSPPPPPSSO
OPPOOOOPPPOOOOPPO
OPPOOOOOPOOOOOPPO
OPPOOOOOOOOOOOPPO
OPPOOOOOOOOOOOPPO
OPPOOOOPPPOOOOPPO
OPPPPPPPCPPPPPPPO
OPPPPPPPPPPPPPPPO
OOOOOOOOOOOOOOOOO