	OOOOOOOOO
OPPPPPPPO
OPSPPPSPO
OPPPPPPPO
OPPPSPPPO
OPPPPPPPO
OOOOPOOOO
OPPPPPPPO
OPSPPPPPO
OPPPCPPPO
OPPPPPSPO
OPPPPPPPO
OOOOOOOOO