	OOOOOOOOO
OPPPPPPPO
OPSPPPSPO
OPPPPPPPO
OPPPCPPPO
OPPPPPPPO
OPSPPPSPO
OPPPPPPPO
OOOOOOOOO